25 5
#########################
#......~................#
d.@....-b........n...e..#
#......~................#
#########################