25 5
#########################
#....c..#...............#
#..............+.j.i.n..#
#.......................#
#............ddd........#
####.#..................#
#....#.......kkk........#
#s...#..@............b..#
#..s.#..................#
#########################