25 5
#########################
#......~................#
d.@....-b............e..#
#......~................#
#########################