25 5
#########################
#......~................#
d.@.A..-b........n...e..#
#......~................#
#########################