25 5
#########################
#......~................#
d......-b........n.A.e..#
#......~................#
#########################