25 10
#########################
#....c..#...............#
#..............+.j.i.n..#
#.......................#
#............ddd........#
####.#..................#
#..s.#.......kkk........#
#s...#...............b..#
#..s.#..................#
#########################